11111111
1S101001
10100011
10110101
10000011
11111111
