      F 0,255,0  
      SO textures/1.png

NO                              textures/2.png
     C 0,0,255
         WE   textures/3.png
EA textures/../textures/4.png


11111111111111111
1110010111100011
100000000000001111
110001110S01000111
110101110000111111
110001110001111111
1111111111110111111111111
           11111111111111