      F 105,105,105
      SO ./textures/South.png

NO                              ./textures/North.png
     C 119,136,153
         WE   ./textures/West.png
EA ./textures/East.png


111 111 111 111 111
101 101 101 101 101
1011101110111011101
1000000000000000001
1010101010101010101
1101010101010101011
1000000N00000000001
1000000000000000001
1011111111111111101
101             101
101             101
1011111111111111101
1000000000000000001
1111111111111111111
